OOOOOOOOOOOOOOOOOOOOOOOOOOOOOOOOOOOOOOOOOOOOOOOOOOOOOOOOOOOOOOOOOOOOOOOOOOOOOOOOOOOOOOOOOOOO
OEOEEEEEEEEEEEEEEEEEEEEEEEEEEEEEEEEEEEEEEEEEEOOEOEEEEEEEEEEEEEEEEEEEEEEEEEEEEEEEEEEEEEEEEEEO
OEOEEEEEEHEEEEEEEEEEEEEEEEEEEEEEEEEEEEEEEEEEEOOEOEEEEEEHEEEEEEEEEEEEEEEEEEEEEEEEEEEEEEEEEEEO
OEEHEEOOEEEEEEEEEEEEEEEEEEEEEEEEEEEEEEEEEEEEEOOEEHEEOOEEEEEEEEEEEEEEEEEEEEEEEEEEEEEEEEEEEEEO
OEEEOEEEEEEEEEEEEEEEEEEEEEEEEEEEEEEEEEEEEEEEEOOEEEOEEEEEEEEEEEEEEEEEEEEEEEEEEEEEEEEEEEEEEEEO
OEEEEEEEEEEEEEEEEEEEEEEEEEEEEEEEEEEEEEEEEEEEEOOEEEEEEEEEEEEEEEEEEEEEEEEEEEEEEEEEEEEEEEEEEEEO
OEEEEEEEEEEEEEEEEEEEEEEEEEEEEEEEEEEEEEEEEEEEEOOEEEEEEEEEEEEEEEEEEEEEEEEEEEEEEEEEEEEEEEEEEEEO
OEEEEEEEEEEEEEEEEEEEEEEEEEEEEEEEEEEEEEEEEEEEEOOEEEEEEEEEEEEEEEEEEEEEEEEEEEEEEEEEEEEEEEEEEEEO
OEEEEEEEEEEEEEEEEEEEEEEEEEEEEEEEEEEEEEEEEEEEEOOEEEEEEEEEEEEEEEEEEEEEEEEEEEEEEEEEEEEEEEEEEEEO
OEEEEEEOOOOOOOOOOEEEEEEEEEEEEEEEEEEEEEEEEEEEEOOEEEEEEOOOOOOOOOOEEEEEEEEEEEEEEEEEEEEEEEEEEEEO
OEEEEEEEEEEEEEEEEEEEEEEEEEEEEEEEEEEEEEEEEEEEEOOEEEEEEEEEEEEEEEEEEEEEEEEEEEEEEEEEEEEEEEEEEEEO
OEEEEEEEEEEEEEEEEEEEEEEEEEEEEEEEEEEEEEEEEEEEEOOEEEEEEEEEEEEEEEEEEEEEEEEEEEEEEEEEEEEEEEEEEEEO
OEEEEEEEEEEEEEEEEEEEEEEEEEEEEEEEEEEEEEEEEEEEEOOEEEEEEEEEEEEEEEEEEEEEEEEEEEEEEEEEEEEEEEEEEEEO
OEEEEEEEEEEEEEEEEEEEEEEEEEEEEEEEEEEEEEEEEEEEEOOEEEEEEEEEEEEEEEEEEEEEEEEEEEEEEEEEEEEEEEEEEEEO
OEEEEEEEEEEEEEEEEEEEEEEEEEEEEEEEEEEEEEEEEEEEEEEEEEEEEEEEEEEEEEEEEEEEEEEEEEEEEEEEEEEEEEEEEEEO
OEEEEEEEEEEEEEEEEEEEEEEEEEEEEEEEEEEEEEEEEEEEEEEEEEEEEEEEEEEEEEEEEEEEEEEEEEEEEEEEEEEEEEEEEEEO
OEEEEEEEEEEEEEEEEEEEEEEEEEEEEEEEEEEEEEEEEEEEEOOEEEEEEEEEEEEEEEEEEEEEEEEEEEEEEEEEEEEEEEEEEEEO
OEEEEEEEEEEEEEEEEEEEEEEEOEEEEEEEEEEEEEEEEEEEEOOEEEEEEEEEEEEEEEEEEEEEEEOEEEEEEEEEEEEEEEEEEEEO
OEEEEEEEEEEEEEEEEEEEEEEEEEEEEEEEEEEEEEEEEEEEEOOEEEEEEEEEEEEEEEEEEEEEEEEEEEEEEEEEEEEEEEEEEEEO
OEEEEEEEEEEEEEEEEEEEEEEEEEEEEEEEEEEEEEEEEEEEEOOFEEEEEEEEEEEEEEEEEEEEEEEEEEEEEEEEEEEEEEEEEEEO
OEEEEEEEEEEEEEEEEEEEOOEEEEEEOOEEEEEEEEEEEEEEEOOEEEEEEEEEEEEEEEEEEEOOEEEEEEOOEEEEEEEEEEEEEEEO
OEEEEEEEEEEEEEEEEEEEOOEEEEEEOOEEEEEEBEEEEEEEEOOEEEEEEEEEEEEEEEEEEEOOEEEEEEOOEEEEEEBEEEEEEEEO
OEEEEEEEEEEEEEEEEEEEOOEEEEEEOOEEEEEEBEEEEEEEEOOEEEEEEEEEEEEEEEEEEEOOEEEEEEOOEEEEEEBEEEEEEEEO
OEEEEEEEEEEEEEEEEEEEOOEEEEEEOOEEEEEEBEEEEEEEEOOEEEEEEEEEEEEEEEEEEEOOEEEEEEOOEEEEEEBEEEEEEEEO
OEEEEEEEEEEEEEEEEEEEOOEEEEEEOOEEEEEEBEEEEEEEEOOEEEEEEEEEEEEEEEEEEEOOEEEEEEOOEEEEEEBEEEEEEEEO
OEEEEEEEEEEEEEEEEEEEOOEEEEEEOOEEEEEEBEEEEEEEEOOEEEEEEEEEEEEEEEEEEEOOEEEEEEOOEEEEEEBEEEEEEEEO
OEEEEEEEEEEEEEEEEEEEOOEEEEEEOOEEEEEEBEEEEEEEEOOEEEEEEEEEEEEEEEEEEEOOEEEEEEOOEEEEEEBEEEEEEEEO
OEEEEEEEEEEEEEEEEEEEOOEEEEEEOOEEEEEEBEEEEEEEEOOEEEEEEEEEEEEEEEEEEEOOEEEEEEOOEEEEEEBEEEEEEEEO
OEOOOOOOOOEEEEEEEEEEOOEEEEEEOOEEEEEEEEEEEEEEEOOEOOOOOOOOEEEEEEEEEEOOEEEEEEOOEEEEEEEEEEEEEEEO
OEEEEEEEEOEEEEEEEEEEOOEEEEEEOOEEEEEEEEEEEEEEEOOEEEEEEEEOEEEEEEEEEEOOEEEEEEOOEEEEEEEEEEEEEEEO
OEEEEEFEEOEEEEEEEEEEOOEEEEEEOOEEEEEEEEEEEEEEEOOEEEEEFEEOEEEEEEEEEEOOEEEEEEOOEEEEEEEEEEEEEEEO
OEEEEEEEEOEEEEEEEEEEOOEEBBEEOOEEEEEEEEEEEEEEEOOEEEEEEEEOEEEEEEEEEEOOEEBBEEOOEEEEEEEEEEEEEEEO
OEOOOOOOOOEEEEEEEEEEOOOOOOOOOOOOOOOOOOOOOOOOOOOEOOOOOOOOEEEEEEEEEEOOOOOOOOOOOOOOOOOOOOOOOOOO
OEEEEEEEEEEEOEEEEEEEOOOOOOOOOOEEEEEEEEEEEEEEEOOEEEEEEEEEEEOEEEEEEEOOOOOOOOOOEEEEEEEEEEEEEEEO
OEEEEEEEEEEEEEEEEEEEEEEEEEEEEEEEEEEEEEEEEEEEEOOEEEEEEEEEEEEEEEEEEEEEEEEEEEEEEEEEEEEEEEEEEEEO
OEEEEEEEEEEEEEEEEEEEEEEEEEEEEEEEEEEEEEEEEEEEEOOEEEEEEEEEEEEEEEEEEEEEEEEEEEEEEEEEEEEEEEEEEEEO
OEEEEEEEEEEEEEEEEEEEEEEEEEEEEEEEEEEEEEEEEEEEEOOEEEEEEEEEEEEEEEEEEEEEEEEEEEEEEEEEEEEEEEEEEEEO
OEEEEEEEEEEEEEEEEEEEEEEEEEEEEEEEEEEEEBEEEEEEEOOEEEEEEEEEEEEEEEEEEEEEEEEEEEEEEEEEEEEBEEEEEEEO
OEEEEEEEEEEEEEEEEEEEEEEEEEEEEEEEEEEEEEEEEEEEEOOEEEEEEEEEEEEEEEEEEEEEEEEEEEEEEEEEEEEEEEEEEEEO
OEEEEEEEEEEEEEEEEEEEEEEEEEEEEEEEEEEEEBEEEEEEEOOEEEEEEEEEEEEEEEEEEEEEEEEEEEEEEEEEEEEBEEEEEEEO
OEEEEEEEEEEEEEEEEEEEEEEEEEEEEEEEEEEEEEEEEEEEEOOEEEEEEEEEEEEEEEEEEEEEEEEEEEEEEEEEEEEEEEEEEEEO
OEEEEEEEEEEEEEEEEEEEEEEEEEEEEEEEEEEEEBEEEEEEEOOEEEEEEEEEEEEEEEEEEEEEEEEEEEEEEEEEEEEBEEEEEEEO
OEEEEEEEEEEEEEEEEEEEEEEEEEEEEEEEEEEEEEEEEEEEEOOEEEEEEEEEEEEEEEEEEEEEEEEEEEEEEEEEEEEEEEEEEEEO
OEEEEEEEEEEEEEEEEEEEEEEEEEEEEEEEEEEEEEEEEEEEEOOEEEEEEEEEEEEEEEEEEEEEEEEEEEEEEEEEEEEEEEEEEEEO
OEEEEEEEEEEEEEEEEEEEEEEEEEEEEEEEEEEEEEEEEEEEEOOEEEEEEEEEEEEEEEEEEEEEEEEEEEEEEEEEEEEEEEEEEEEO
OEEEEEEEEEEEEEEEEEEEEEEEEEEEEEEEEEEEEEEEEEEEEOOEEEEEEEEEEEEEEEEEEEEEEEEEEEEEEEEEEEEEEEEEEEEO
OEEEEEEEEEEEEEEEEEEEEEEEEEEEEEEEEEEEEEEEEEEEEOOEEEEEEEEEEEEEEEEEEEEEEEEEEEEEEEEEEEEEEEEEEEEO
OEEEEEEEEEEEEEEEEEEEEEEEEEEEEEEEEEEEEEEEEEEEEOOEEEEEEEEEEEEEEEEEEEEEEEEEEEEEEEEEEEEEEEEEEEEO
OEEEEEEEEEEEEEEEEEEEEEEEEEEEEEEEEEEEEEEEEEEEEOOEEEEEEEEEEEEEEEEEEEEEEEEEEEEEEEEEEEEEEEEEEEEO
OEEEEEEEEEEEEEEEEEEEEEEEEEEEEEEEEEEEEEEEEEEEEOOEEEEEEEEEEEEEEEEEEEEEEEEEEEEEEEEEEEEEEEEEEEEO
OEEEEEEEEEEEEEEEEEEEEEEEEEEEEEEEEEEEEEEEEEEEEOOEEEEEEEEEEEEEEEEEEEEEEEEEEEEEEEEEEEEEEEEEEEEO
OEEEEEEEEEEEEEEEEEEEEEEEEEEEEEEEEEEEEEEEEEEEEOOEEEEEEEEEEEEEEEEEEEEEEEEEEEEEEEEEEEEEEEEEEEEO
OEEEEEEEEEEEEEEEEEEEEEEEEEEEEEEEEEEEEEEEEEEEEOOEEEEEEEEEEEEEEEEEEEEEEEEEEEEEEEEEEEEEEEEEEEEO
OEEEEEEEEEEEEEEEEEEEEEEEEEEEEEEEEEEEEEEEEEEEEOOEEEEEEEEEEEEEEEEEEEEEEEEEEEEEEEEEEEEEEEEEEEEO
OEEEEEEEEEEEEEEEEEEEEEEEEEEEEEEEEEEEEEEEEEEEEOOEEEEEEEEEEEEEEEEEEEEEEEEEEEEEEEEEEEEEEEEEEEEO
OEEEEEEEEEEEEEEEEEEEEEEEEEEEEEEEEEEEEEEEEEEEEOOEEEEEEEEEEEEEEEEEEEEEEEEEEEEEEEEEEEEEEEEEEEEO
OEEEEEEEEEEEEEEEEEEEEEEEEEEEEEEEEEEEEEEEEEEEEOOEEEEEEEEEEEEEEEEEEEEEEEEEEEEEEEEEEEEEEEEEEEEO
OEEEEEEEEEEEEEEEEEEEEEEEEEEEEEEEEEEEEEEEEEEEEOOEEEEEEEEEEEEEEEEEEEEEEEEEEEEEEEEEEEEEEEEEEEEO
OEEEEEEEEEEEEEEEEEEEEEEEEEEEEEEEEEEEEEEEEEEEEOOEEEEEEEEEEEEEEEEEEEEEEEEEEEEEEEEEEEEEEEEEEEEO
OEEEEEEEEEEEEEEEEEEEEEEEEEEEEEEEEEEEEEEEEEEEEOOEEEEEEEEEEEEEEEEEEEEEEEEEEEEEEEEEEEEEEEEEEEEO
OEEEEEEEEEEEEEEEEEEEEEEEEEEEEEEEEEEEEEEEEEEEEOOEEEEEEEEEEEEEEEEEEEEEEEEEEEEEEEEEEEEEEEEEEEEO
OEEEEEEEEEEEEEEEEEEEEEEEEEEEEEEEEEEEEEEEEEEEEOOEEEEEEEEEEEEEEEEEEEEEEEEEEEEEEEEEEEEEEEEEEEEO
OEEEEEEEEEEEEEEEEEEEEEEEEEEEEEEEEEEEEEEEEEEEEOOEEEEEEEEEEEEEEEEEEEEEEEEEEEEEEEEEEEEEEEEEEEEO
OEEEEEEEEEEEEEEEEEEEEEEEEEEEEEEEEEEEEEEEEEEEEOOEEEEEEEEEEEEEEEEEEEEEEEEEEEEEEEEEEEEEEEEEEEEO
OEEEEEEEEEEEEEEEEEEEEEEEEEEEEEEEEEEEEEEEEEEEEOOEEEEEEEEEEEEEEEEEEEEEEEEEEEEEEEEEEEEEEEEEEEEO
OEEEEEEEEEEEEEEEEEEEEEEEEEEEEEEEEEEEEEEEEEEEEOOEEEEEEEEEEEEEEEEEEEEEEEEEEEEEEEEEEEEEEEEEEEEO
OEEEEEEEEEEEEEEEEEEEEEEEEEEEEEEEEEEEEEEEEEEEEOOEEEEEEEEEEEEEEEEEEEEEEEEEEEEEEEEEEEEEEEEEEEEO
OEEEEEEEEEEEEEEEEEEEEEEEEEEEEEEEEEEEEEEEEEEEEOOEEEEEEEEEEEEEEEEEEEEEEEEEEEEEEEEEEEEEEEEEEEEO
OEEEEEEEEEEEEEEEEEEEEEEEEEEEEEEEEEEEEEEEEEEEEOOEEEEEEEEEEEEEEEEEEEEEEEEEEEEEEEEEEEEEEEEEEEEO
OEEEEEEEEEEEEEEEEEEEEEEEEEEEEEEEEEEEEEEEEEEEEOOEEEEEEEEEEEEEEEEEEEEEEEEEEEEEEEEEEEEEEEEEEEEO
OEEEEEEEEEEEEEEEEEEEEEEEEEEEEEEEEEEEEEEEEEEEEOOEEEEEEEEEEEEEEEEEEEEEEEEEEEEEEEEEEEEEEEEEEEEO
OEEEEEEEEEEEEEEEEEEEEEEEEEEEEEEEEEEEEEEEEEEEEOOEEEEEEEEEEEEEEEEEEEEEEEEEEEEEEEEEEEEEEEEEEEEO
OEEEEEEEEEEEEEEEEEEEEEEEEEEEEEEEEEEEEEEEEEEEEOOEEEEEEEEEEEEEEEEEEEEEEEEEEEEEEEEEEEEEEEEEEEEO
OEEEEEEEEEEEEEEEEEEEEEEEEEEEEEEEEEEEEEEEEEEEEOOEEEEEEEEEEEEEEEEEEEEEEEEEEEEEEEEEEEEEEEEEEEEO
OEEEEEEEEEEEEEEEEEEEEEEEEEEEEEEEEEEEEEEEEEEEEOOEEEEEEEEEEEEEEEEEEEEEEEEEEEEEEEEEEEEEEEEEEEEO
OEEEEEEEEEEEEEEEEEEEEEEEEEEEEEEEEEEEEEEEEEEEEOOEEEEEEEEEEEEEEEEEEEEEEEEEEEEEEEEEEEEEEEEEEEEO
OEEEEEEEEEEEEEEEEEEEEEEEEEEEEEEEEEEEEEEEEEEEEOOEEEEEEEEEEEEEEEEEEEEEEEEEEEEEEEEEEEEEEEEEEEEO
OEEEEEEEEEEEEEEEEEEEEEEEEEEEEEEEEEEEEEEEEEEEEOOEEEEEEEEEEEEEEEEEEEEEEEEEEEEEEEEEEEEEEEEEEEEO
OEEEEEEEEEEEEEEEEEEEEEEEEEEEEEEEEEEEEEEEEEEEEOOEEEEEEEEEEEEEEEEEEEEEEEEEEEEEEEEEEEEEEEEEEEEO
OEEEEEEEEEEEEEEEEEEEEEEEEEEEEEEEEEEEEEEEEEEEEOOEEEEEEEEEEEEEEEEEEEEEEEEEEEEEEEEEEEEEEEEEEEEO
OEEEEEEEEEEEEEEEEEEEEEEEEEEEEEEEEEEEEEEEEEEEEOOEEEEEEEEEEEEEEEEEEEEEEEEEEEEEEEEEEEEEEEEEEEEO
OEEEEEEEEEEEEEEEEEEEEEEEEEEEEEEEEEEEEEEEEEEEEOOEEEEEEEEEEEEEEEEEEEEEEEEEEEEEEEEEEEEEEEEEEEEO
OEEEEEEEEEEEEEEEEEEEEEEEEEEEEEEEEEEEEEEEEEEEEOOEEEEEEEEEEEEEEEEEEEEEEEEEEEEEEEEEEEEEEEEEEEEO
OEEEEEEEEEEEEEEEEEEEEEEEEEEEEEEEEEEEEEEEEEEEEOOEEEEEEEEEEEEEEEEEEEEEEEEEEEEEEEEEEEEEEEEEEEEO
OEEEEEEEEEEEEEEEEEEEEEEEEEEEEEEEEEEEEEEEEEEEEOOEEEEEEEEEEEEEEEEEEEEEEEEEEEEEEEEEEEEEEEEEEEEO
OEEEEEEEEEEEEEEEEEEEEEEEEEEEEEEEEEEEEEEEEEEEEOOEEEEEEEEEEEEEEEEEEEEEEEEEEEEEEEEEEEEEEEEEEEEO
OEEEEEEEEEEEEEEEEEEEEEEEEEEEEEEEEEEEEEEEEEEEEOOEEEEEEEEEEEEEEEEEEEEEEEEEEEEEEEEEEEEEEEEEEEEO
OEEEEEEEEEEEEEEEEEEEEEEEEEEEEEEEEEEEEEEEEEEEEOOEEEEEEEEEEEEEEEEEEEEEEEEEEEEEEEEEEEEEEEEEEEEO
OEEEEEEEEEEEEEEEEEEEEEEEEEEEEEEEEEEEEEEEEEEEEOOEEEEEEEEEEEEEEEEEEEEEEEEEEEEEEEEEEEEEEEEEEEEO
OEEEEEEEEEEEEEEEEEEEEEEEEEEEEEEEEEEEEEEEEEEEEOOEEEEEEEEEEEEEEEEEEEEEEEEEEEEEEEEEEEEEEEEEEEEO
OOOOOOOOOOOOOOOOOOOOOOOOOOOOOOOOOOOOOOOOOOOOOOOOOOOOOOOOOOOOOOOOOOOOOOOOOOOOOOOOOOOOOOOOOOOO