OOOOOOOOOOOOOOOOOOOOOOOOOOOOOOOOOOOOOOOOOOOOOOOOOOOOOOOOOOOOOOOOOOOOOOOOOOOOOOOOOOOOOOOOOOOO
O.O..........................................OO.O..........................................O
O.O......H...................................OO.O......H...................................O
O..H..OO.....................................OO..H..OO.....................................O
O...O........................................OO...O........................................O
O............................................OO............................................O
O............................................OO............................................O
O............................................OO............................................O
O............................................OO............................................O
O......OOOOOOOOOO............................OO......OOOOOOOOOO............................O
O............................................OO............................................O
O............................................OO............................................O
O............................................OO............................................O
O............................................OO............................................O
O..........................................................................................O
O..........................................................................................O
O............................................OO............................................O
O.......................O....................OO.......................O....................O
O............................................OO............................................O
O............................................OOF...........................................O
O...................OO......OO...............OO...................OO......OO...............O
O...................OO......OO......B........OO...................OO......OO......B........O
O...................OO......OO......B........OO...................OO......OO......B........O
O...................OO......OO......B........OO...................OO......OO......B........O
O...................OO......OO......B........OO...................OO......OO......B........O
O...................OO......OO......B........OO...................OO......OO......B........O
O...................OO......OO......B........OO...................OO......OO......B........O
O...................OO......OO......B........OO...................OO......OO......B........O
O.OOOOOOOO..........OO......OO...............OO.OOOOOOOO..........OO......OO...............O
O........O..........OO......OO...............OO........O..........OO......OO...............O
O.....F..O..........OO......OO...............OO.....F..O..........OO......OO...............O
O........O..........OO..BB..OO...............OO........O..........OO..BB..OO...............O
O.OOOOOOOO..........OOOOOOOOOOOOOOOOOOOOOOOOOOO.OOOOOOOO..........OOOOOOOOOOOOOOOOOOOOOOOOOO
O...........O.......OOOOOOOOOO...............OO...........O.......OOOOOOOOOO...............O
O............................................OO............................................O
O............................................OO............................................O
O............................................OO............................................O
O....................................B.......OO....................................B.......O
O............................................OO............................................O
O....................................B.......OO....................................B.......O
O............................................OO............................................O
O....................................B.......OO....................................B.......O
O............................................OO............................................O
O............................................OO............................................O
O............................................OO............................................O
O............................................OO............................................O
O............................................OO............................................O
O............................................OO............................................O
O............................................OO............................................O
O............................................OO............................................O
O............................................OO............................................O
O............................................OO............................................O
O............................................OO............................................O
O............................................OO............................................O
O............................................OO............................................O
O............................................OO............................................O
O............................................OO............................................O
O............................................OO............................................O
O............................................OO............................................O
O............................................OO............................................O
O............................................OO............................................O
O............................................OO............................................O
O............................................OO............................................O
O............................................OO............................................O
O............................................OO............................................O
O............................................OO............................................O
O............................................OO............................................O
O............................................OO............................................O
O............................................OO............................................O
O............................................OO............................................O
O............................................OO............................................O
O............................................OO............................................O
O............................................OO............................................O
O............................................OO............................................O
O............................................OO............................................O
O............................................OO............................................O
O............................................OO............................................O
O............................................OO............................................O
O............................................OO............................................O
O............................................OO............................................O
O............................................OO............................................O
O............................................OO............................................O
O............................................OO............................................O
O............................................OO............................................O
O............................................OO............................................O
O............................................OO............................................O
O............................................OO............................................O
O............................................OO............................................O
O............................................OO............................................O
O............................................OO............................................O
OOOOOOOOOOOOOOOOOOOOOOOOOOOOOOOOOOOOOOOOOOOOOOOOOOOOOOOOOOOOOOOOOOOOOOOOOOOOOOOOOOOOOOOOOOOO