OOOOOOOOOOOOOOOOOOOOOOOOOOOOOOOOOOOOOOOOOOOOOOOOOOOOOOOOOOOOOOOOOOOOO
O........................................................O..........O
O........................................................O..........O
O...............H........................................O....F.....O
O........................................................O....F.....O
O........................................................O....F.....O
O........................................................O....F.....O
O........................................................O..........O
O........................................................O..........O
O........................................................O..........O
O........................................................O...OOO....O
O........................................................O...OOO....O
O........................................................O...OOO....O
O........................................................O..........O
O........................................................O..........O
O........................................................O..........O
O........................................................O..........O
O...............................................OOO.................O
O...............................................OOO.................O
O...............................................OOO.......OOOOOOOOOOO
O...................................................................O
O...................................................................O
O...................................................................O
O...................................................................O
O...................................................................O
O...................................................................O
O...................................................................O
O................B.....................B............................O
O...................................................................O
O................B.....................B............................O
O...................................................................O
O...................................................................O
O...................................................................O
O...................................................................O
O...................................................................O
O...................................................................O
O...................................................................O
O...................................................................O
O...................................................................O
O...................................................................O
O...................................................................O
O...................................................................O
O...................................................................O
O...................................................................O
O...................................................................O
O...................................................................O
O...................................................................O
O...................................................................O
O...................................................................O
O...................................................................O
O...................................................................O
O...................................................................O
O...................................................................O
O...................................................................O
O...................................................................O
O...................................................................O
O...................................................................O
O...................................................................O
O...................................................................O
O...................................................................O
O...................................................................O
O...................................................................O
O...................................................................O
O...................................................................O
O...................................................................O
O...................................................................O
O...................................................................O
O...................................................................O
O...................................................................O
OOOOOOOOOOOOOOOOOOOOOOOOOOOOOOOOOOOOOOOOOOOOOOOOOOOOOOOOOOOOOOOOOOOOO