OOOOOOOOOOOOOOO
O.............O
O.............O
O.............O
O.............O
O.............O
O........O....O
O........O....O
O.......FO....O
O........O....O
O........O....O
O........O....O
O........O....O
O........O....O
O........O....O
OOOOOOOOOOOOOOO