OOOOOOOOOO
O........O
O..NF....O
O........O
O........O
O...O....O
O.B.O....O
O...O....O
OOOOOOOOOO