00000000000000000000000000000000000000000000000000000000000000000000000000000000
11110111111011111011111101111110111110111111011111101111101111101111110111110111
11110111111011111011111101111110111110111111011111101111101111101111110111110111
01110110111011011011011101101110110110110111011011101101101101101101110110110110
01110110111011011011011101101110110110110111011011101101101101101101110110110110
01110110111011011011011101101110110110110111011011101101101101101101110110110110
01110110111011011011011101101110110110110111011011101101101101101101110110110110
01110110111011011011011101101110110110110111011011101101101101101101110110110110
01110110111011011011011101101110110110110111011011101101101101101101110110110110
01110110111011011011011101101110110110110111011011101101101101101101110110110110
01110110111011011011011101101110110110110111011011101101101101101101110110110110
01110110111011011011011101101110110110110111011011101101101101101101110110110110
01110110111011011011011101101110110110110111011011101101101101101101110110110110
01110110111011011011011101101110110110110111011011101101101101101101110110110110
01110110111011011011011101101110110110110111011011101101101101101101110110110110
01110110111011011011011101101110110110110111011011101101101101101101110110110110
01110110111011011011011101101110110110110111011011101101101101101101110110110110
01110110111011011011011101101110110110110111011011101101101101101101110110110110
01110110111011011011011101101110110110110111011011101101101101101101110110110110
01110110111011011011011101101110110110110111011011101101101101101101110110110110
01110110111011011011011101101110110110110111011011101101101101101101110110110110
01110110111011011011011101101110110110110111011011101101101101101101110110110110
01110110111011011011011101101110110110110111011011101101101101101101110110110110
01110110111011011011011101101110110110110111011011101101101101101101110110110110
11110110111011011011011101101110110110110111011111101101101101101101110110110111
11110110111011011011011101101110110110110111011111101101101101101101110110110111
01110110111011011011011101101110110110110111011011101101101101101101110110110110
01110110111011011011011101101110110110110111011011101101101101101101110110110110
01110110111011011011011101101110110110110111011011101101101101101101110110110110
01110110111011011011011101101110110110110111011011101101101101101101110110110110
01110110111011011011011101101110110110110111011011101101101101101101110110110110
01110110111011011011011101101110110110110111011011101101101101101101110110110110
01110110111011011011011101101110110110110111011011101101101101101101110110110110
01110110111011011011011101101110110110110111011011101101101101101101110110110110
01110110111011011011011101101110110110110111011011101101101101101101110110110110
01110110111011011011011101101110110110110111011011101101101101101101110110110110
01110110111011011011011101101110110110110111011011101101101101101101110110110110
01110110111011011011011101101110110110110111011011101101101101101101110110110110
01110110111011011011011101101110110110110111011011101101101101101101110110110110
01110110111011011011011101101110110110110111011011101101101101101101110110110110
01110110111011011011011101101110110110110111011011101101101101101101110110110110
01110110111011011011011101101110110110110111011011101101101101101101110110110110
01110110111011011011011101101110110110110111011011101101101101101101110110110110
01110110111011011011011101101110110110110111011011101101101101101101110110110110
01110110111011011011011101101110110110110111011011101101101101101101110110110110
01110110111011011011011101101110110110110111011011101101101101101101110110110110
11110110111011011011011101101110110110110111011111101101101101101101110110110111
11110110111011011011011101101110110110110111011111101101101101101101110110110111
01110110111011011011011101101110110110110111011011101101101101101101110110110110
01110110111011011011011101101110110110110111011011101101101101101101110110110110
01110110111011011011011101101110110110110111011011101101101101101101110110110110
01110110111011011011011101101110110110110111011011101101101101101101110110110110
01110110111011011011011101101110110110110111011011101101101101101101110110110110
01110110111011011011011101101110110110110111011011101101101101101101110110110110
01110110111011011011011101101110110110110111011011101101101101101101110110110110
01110110111011011011011101101110110110110111011011101101101101101101110110110110
01110110111011011011011101101110110110110111011011101101101101101101110110110110
01110110111011011011011101101110110110110111011011101101101101101101110110110110
11110110111011011011011101101110110110110111011111101101101101101101110110110111
11110110111011011011011101101110110110110111011111101101101101101101110110110111
01110110111011011011011101101110110110110111011011101101101101101101110110110110
01110110111011011011011101101110110110110111011011101101101101101101110110110110
01110110111011011011011101101110110110110111011011101101101101101101110110110110
01110110111011011011011101101110110110110111011011101101101101101101110110110110
01110110111011011011011101101110110110110111011011101101101101101101110110110110
01110110111011011011011101101110110110110111011011101101101101101101110110110110
01110110111011011011011101101110110110110111011011101101101101101101110110110110
01110110111011011011011101101110110110110111011011101101101101101101110110110110
01110110111011011011011101101110110110110111011011101101101101101101110110110110
01110110111011011011011101101110110110110111011011101101101101101101110110110110
01110110111011011011011101101110110110110111011011101101101101101101110110110110
01110110111011011011011101101110110110110111011011101101101101101101110110110110
01110110111011011011011101101110110110110111011011101101101101101101110110110110
01110110111011011011011101101110110110110111011011101101101101101101110110110110
01110110111011011011011101101110110110110111011011101101101101101101110110110110
01110110111011011011011101101110110110110111011011101101101101101101110110110110
01110110111011011011011101101110110110110111011011101101101101101101110110110110
01111110111111011111011111101111110111110111111011111101111101111101111110111110
01111110111111011111011111101111110111110111111011111101111101111101111110111110
00000000000000000000000000000000000000000000000000000000000000000000000000000000