000000000000000000000
111101111110111110111
111101111110111110111
011101101110110110110
011101101110110110110
011101101110110110110
011101101110110110110
011101101110110110110
011101101110110110110
011101101110110110110
011101101110110110110
011101101110110110110
011101101110110110110
011101101110110110110
011101101110110110110
011111101111110111110
011111101111110111110
000000000000000000000