------00000000000000000
00000-00000000000000000
00000-00000000000000000
00000-00000000000000000
00000-00000000000000000
00000-00000000000000000
00000-00000000000000000
00000-00000000000000000
00000------------000000
00000000000000000000000
00000000000000000000000
00000000000000000000000
00000000000000000000000
00000------------000000
0000000000000000-000000
0000000000000000-000000
0000000000000000-000000
0000000000000000-000000
0000000000000000-000000
0000000000000000-000000
0000000000000000-000000
0000000000000000-000000
0000000000000000-------
