000000001111111111111111111111
111111101111111111111111111111
111111101111111111111111111111
111111101111111111111111111111
111111101111111111111111111111
111111101111111111111111111111
111111101111111111111111111111
111111100000000000011111111111
111111111111111111111111111111
111111111111111111111111111111
111111111111111111111111111111
111111111111111111111111111111
111111100000000000011111111111
111111111111111111011111111111
111111111111111111011111111111
111111111111111111011111111111
111111111111111111011111111111
111111111111111111011111111111
111111111111111111011111111111
111111111111111111011111111111
111111111111111111011111111111
111111111111111111011111111111
111111111111111111000000000000

